12
11
||||||||||||
|OOOOOOOOOO|
|DDDDDDDDDD|
|DCDDDDDDDD|
|D DDDDDDDD|
|D DDDDDDDD|
|D DDDDDDDD|
|D DDDDDDDD|
|D DDDDDDDD|
|DVVVVVVVVE|
||||||||||||