12
11
||||||||||||
|DODDDDDDDD|
|D DDDDDVDD|
|DCDDD   DD|
|D DDD   DD|
|D DDD   DD|
|D DDDDDDDD|
|D DDDDDDDD|
|D DDDDDDDD|
|DVVVVVVVVX|
||||||||||||