20
20
||||||||||||||||||||
|DD E DDD|DDDDDDDOD|
|DD   DDD DDDDDXDVD|
|DDDVDDDD|DDDDDDDDD|
|DDVDVDDD|DDDDDDDDD|
|||||||||||| |||||||
|DDDDDDDDDDDDDD EDD|
|DDDDVDDDDDDDDD  DD|
|DDOODDDDDDDDDDDDDD|
|DODDVDDDDDDDDDDDDD|
|DDDDDDDDDDDDODDDDD|
|DD  ODDDDDDODODDDD|
|DD EDDDDDDDVVVDDDD|
|DDDDDDDDDDDDDDDDDD|
|DDDDD||||||||||||||
|ODDDDDDDDDDDDDDDDD|
|ODDDDDDDDDDDDDDDDD|
|DVDDOODDDDDDDDCDDD|
|DDDDDDDDDDDDDDDDDD|
||||||||||||||||||||