90
7
||||||||||||||||||||||||||||||||||||||||||||||||||||||||||||||||||||||||||||||||||||||||||
|D E                                          |                                     VDDDX|
|DDDDDDDD|DDDDDDDVDDDVV|||||||||||||||||V||||||||DDD||DDDDDDDDD||D||||||||||||||||||||||||
|  C                                         O                                     VVVVVO|
|DDDDDDDDDDDDDDDDVDDDDDDDDDDDD||||||||||D||D|DDDD|||DDDDDDDDD||||||DDDDDDDDDDDDDDDDDDDDDD|                                                      |
|D E                                               |OOO                                  |
||||||||||||||||||||||||||||||||||||||||||||||||||||||||||||||||||||||||||||||||||||||||||