12
5
||||||||||||
|DDDDDDDDDD|
|C VVVVVVVX|
|DDDDDDDDDD|
||||||||||||
